11111
10P11
10111
10C11
1E0S1
11111