1111111111111
10000000000C
1010011101111
1P1C11E001001
1111111111111